EAAAAAAAAAAAFEAAAAFEAAAAAAAAF
DOOOOOOOOOOOBD1311BD2OOOO1OOB
DOOOOOOOOOOOBDOOO1BDOOOO111OB
DOOMOOOOOMOOLKOOOOLKOOOOO1OOB
DOOOOOPOOOOOOOOOO2OOOOOXOOOOB
DOOOOOOOOOOOIJOOOOIJOOOOOOOOB
DOOMOOOOOMOOBDOOOOBDOOOOOOOOB
DOOOOOOOOOOOBD1OOOBD1OOOYOOOB
DOOOOOOOOOOOBD11O2BD21OOOOO2B
HCCCCJOICCCCGHJOOIGHCCJOICCCG
EAAAAKOLAAAAAAKOOLAAAAKOLAAAF
D11OOOOOOOO11OOOOOOOOOOOOO2OB
D1OOOOOOOOOOOOOOOOOOOOOOOOOOB
DOOOOOOOOOOOOXOOOOOO1OOOOOZOB
DOOZOOOO2OOOOOOOOOO111OOOOOOB
HCCCCCCCCCCCCJOOICCCCCCCCCCCG
EAAAAAAAAAAAAKOOLAAAAAAAAAAAF
DOOOOOOOYOOOOOOOOOOOOOYOOOOOB
DXOOOZOOOOOOOOOOOOOOOOOOZOOOB
DOOOOOOOOOYOOOOOOOOOYOOOOOOOB
DXOOOOOOOOOOOOOYOOOOOOOOOOOOB
DSXOOOXOOOOZOOOOOOOZOOOOOOOOB
HCCCCCCCCCCCCCCCCCCCCCCCCCCCG