EAAAAAAAAAAAAF-------------EAAAAAAFEAAAAAAAAAAAAAAAAAF
D322OOYOOOOOYB-------------DOOOOOOBDOOOOOZOOOOOOOOOOZB
HCCCCCCCCJOICGEAAAAAAAAAAAFDOOOOOOLKOOOMOOOOMOOOOMOOOB
-------EAKOLAFDOOOOOOOOOOOBDOOYOOOOOOOOOOOOOOOOOOOOOOB
EAAAAAFDOOOXOLKOOOOOOOOOOOBDOOOOOOIJOOOOOOOOOOOOOOOOZB
D2Z3O2BDOOOOOOOOOMOOOOOMOOBDOOOOOOBHCCCCCCCCCCCJOICCCG
DOOOOOBDXOOOOIJOOOOOOOOOOOBDOOOOOOBEAAAAAAFEAAAKOLAAAF
DOOOOOBHCJOICGDOOOOOPOOOOOBHCCJOICGD3OOOO3BDOOOOOOOOZB
DOOOXOBEAKOLAFDOOMOOOOOMOOB-EAKOLAFDOOOZOOBDOOOO2OOOOB
D1OOOOBD1OOO1BDOOOOOOOOOOOB-DOOOOOLKOOOOOOBDOOO2M2OOOB
D1OOO1BD31O11BDOOOOOOOOOOOB-DOOXOOOOOOOOOOBDOOO323OOOB
HCJOICGHCCCCCGHCCCCJOICCCCG-DOOOOOIJOOOOOOBDOOOOOOOOZB
EAKOLAAAAAAAAAFEAAAKOLAAAAF-DOOOOOBDOOOOZOBHCCCCCCCCCG
DOOOOOOOOOOOOOLKOOOOOOOOOOB-HCJOICGHCCCCCCG-----------
DOOOOOYOOOOOOOOOOOOOOOOOYOBEAAKOLAAAF---EAAAAAAAAAAAAF
DOOOOOOOOOOOOOIJOOOOOOOOOOLKOOOOOOOOB---DOOOOOOYOOOOOB
HCCCCCJOICCCCCGDOOOOOOOOOOOOOOOOOXOOB---DOOYOOOOOOOYOB
--EAAAKOLAAAF--DOOOOZOOOOOIJOOOOOOOOB---DOOOOOOYOOOOOB
--DOOOOOOOOOB--DOOOOOOOOOOBHCJOICCJOB---DSOOOOOOOOOOOB
--DOOOOOOOYOB--HCCCCCCCCCCGEAKOLFEKOLAAFHCCCCCCCJOICCG
--DOOXOOOOOOBEAAAAAAAAAAAAFD1OYOBDOOOOOBEAAAAAFEKOLF--
--DOOOOOOOOOBD322OOOOYOOOOBD11O1BDOOOOOBD11111BDZOOB--
--HCJOICCCCCGHCCCCCCJOICCCGHCCCCGDOOOOOLKOXOOOLKOOOB--
EAAAKOLAAF---EAAAAAAKOLAAAAAAAAF-DOOOOOOOOOOOOOOOOOB--
DOOOOOOOOB---DOOOOOOOOOOOOOOOOYLAKOOOOOIJOOXOOIJOOOB--
DOZOOOOOOB---DOOMOOOOOMOOXOOMOOOOOOOOOOBDOOOOOBDOOZB--
DOOOMOOYOB---DOOOOOOOOOOOOOOOOOICJOOOOOBHCJOICGHJOIG--
D2XOOOOOOB---DOOOOOOOOOOOOOOOOOB-HCJOICGEAKOLAFEKOLAAF
D22OYOOO3B---DOOMOOOOOMOOZOOMOOBEAAKOLAFDOOOOOBDOOYOOB
HCCCCCCCCG---DOOOOOOOOOOOOOOOOOBD11OXOOBD1OZO1BD2O3O2B
-------------HCCCCCCCCCCCCCCCCCGD111OOOBD11O11BHCCCCCG
--------------------------------HCCCCCCGHCCCCCG-------